1111111111111
1C00C00C000P1
1000011111111
1000C00C000E1
1111111111111
