1111111111111
11000000000C1
1000011111001
1P001100C00E1
1111111111111
