1111111111111
1000C00C000P1
1000011111111
100000C0000E1
1111111111111
