1111111111111
1000C00C000P1
1000011111111
1000C0000C0E1
1111111111111
