1111111111111111111111111111111111
1E0000000000000C00000C000000000001
1111111110000000001111000000011111
1111111111111110001111000000011111
1P0000000C00C0000000000000000000C1
1111111111111111111111111111111111
