1111111111111111111111111111111111
1E0000000000000C00000C000C00000001
1111111110000001111111000000011111
1111111110000001111111000000011111
1P0000000C00C00C000000000C00000001
1111111111111111111111111111111111
