1111111111111111111111111111111111
1E0000000000000C00000C000000000001
1011111111100000001111000000011101
1011111111111110001111000000011101
1P0000000C00C0000000000000000000C1
1111111111111111111111111111111111
