1111111111111111111111111111111111111111111111111111
100000000000000C0000000C0000000000000000000000000001
1010010100100000101001000000010101010101010101010101
100000000C0000000000000000000000000000000000000000C1
1111100000000011111000000010101010101010101010101011
1P00000000000000000000000000000000000000000000000001
1111000011111111111111110000111111111111111000011111
1C000000C00000000C000000C000000000000000000000000001
1010101000100010101000100010101000101010101010101011
10000000000000000000000000000000000000000000000000C1
1111100000000011111000000010101010101010101010101011
1E00000000000000000000000C00000000000000000000000001
1111111111111111111111111111111111111111111111111111
