1111111111111111111111111111111111111111111111111111
100000000000000C0000000C0000000000000000000000000001
1111111111100000111111100000011111111111111111111001
100000000C0000000000000000000000000000000000000000C1
1111111111000011111100000011111000111111100000111111
1P00000000000000000000000000000000000000000000000001
1111110011111111111111110000111111111111111000011111
1C000000C00000000C000000C000000000001100000000000111
1111111000000000000000000000001000101111111110000111
11111110000000000000000000000000000000000000000000C1
1111111000000011111000000011111111111111111000001111
1E00000000000000000000000C00000000000000000000000001
1111111111111111111111111111111111111111111111111111
