11111111111111111111111111111111111111111111111111111111111111111111111111
1E0000000000000C0000000C000000000000000000000000000000000C0000000000000001
10100101001000001010010000000101010101010101010101010101010101010101010101
10100100101010100010010000000101010101010101010101010101010101010101010101
100000000C00C00000000000000000000000000000000000000000000000000000000000C1
10101010101010101010101010101010101010101010101010101010101010101010101011
10000000000000000000000000000000000000000000000000000000000000000000000001
11110111111111111111111111111000000000000001111111111111000000000000001111
1C000000C00000000C000000C0000000000000000000000000000000000C00000000000001
10101010101010101010101010101010101010101010101010101010101010101010101011
100000000000000000000000000000000000000000000000000000000000000000000000C1
11110111100000000000000111111111111111111111111111000000000000001111111111
1C00000000000C00000000000C000000000000000000000000000000000000000000000001
10100101001000001010010000000101010101010101010101010101010101010101010101
10100100101010100010010000000101010101010101010101010101010101010101010101
1P0000000C00C000000000000000000000000000000000000000000C0000000000000000C1
10101010101010101010101010101010101010101010101010101010101010101010101011
10000000000000000000000000000000000000000000000000000000000000000000000001
111101111111111111111111111110000000000000011111111111110000000C0000001111
1C000000C00000000C000000C0000000000000000000000000000000000000000000000001
10101010101010101010101010101010101010101010101010101010101010101010101011
11111111111111111111111111111111111111111111111111111111111111111111111111
